11111
10C01
1P0E1
10001
11111
