11111111111111111111111111111111111111111111111111111111111111111111111111111111111
1E1000000000000C00000C0000000000000000000000000000000000000000000000000000000000001
10100101001000001010010000000101010010100000000000000000000000000000000000000000001
10100100101010100010010000000101010010100000000000000000000000000000000000000000001
1C0000000C00C0000000000000000000000000000000000000000000000000000000000000000000001
1C000000000000000000C00000000000000000000000000000000000000000000000000000000000001
1C000000000000000000C00000000000000000000000000000000000000000000000000000000000001
10100100101010100010010000000101010010100000000000000000000000000000000000000000001
1P000000000000000000000000000000000000000000000000000000000000000000000000000000001
11111111111111111111111111111111111111111111111111111111111111111111111111111111111
